1111111
100ECP1
1000001
1000001
1000001
100CCC1
1000001
1001111
1000001
100CCC1
1000001
1000001
1000001
1111111