11111111111
1111C0000C1
10000C11001
10000111001
1P0011011E1
11111111111