11111111111111111
1CC0000000000E0C1
1C1010000000101C1
1C000000000000001
1000000P011000001
1C00C0000000CCCC1
1C0C01C100000CCC1
1CC01000100000001
11111111111111111
