111111111111111111111111111111111
1CCC00001CC11CC1001111111010CCCC1
1C1111101C011CC1001111111010111C1
1CCCC0000000C0001C1CC1CC1010001C1
1011111111111110101C010C101011101
1000001111000010100000000000001C1
111001111111101010111110001100111
1100001CC00C101010CC1000111111111
1P0110011010101010111110001111111
100C000000000010000000001111CC111
1110111110011010001111111CC1C0111
111000100000001010000000000000111
11101110111001101011111C011110111
11C00010CC1CC1100000111C011C001C1
1CC1101011111C00111011111111101C1
111CC00000111E001100CC11111C00CC1
111111111111111111111111111111111
