11111111111
11110000001
10000011M01
100C0111001
1P0011011E1
11111111111