1111111111111111111111111111111111111
1111100000000000000000000000000111111
11100000000000CC000C11111CCCCCCCC11C1
11001111CCCCCCC11111111111111CCCCCCC1
1C001111111111111111111111111111CCCC1
1C00C111CCCCCCCCCCCCCCCCCCCCCCCCCCCE1
1100CCC11111111111111111111CCCCCCCCC1
1100CC11111CCCCCCCCCCCCCC1111CCCCCCC1
1100C11111CCCCCCCCCCCCCCCC111111CCCC1
110011111CC111111111111CCC1111111CCC1
11001111CC11CCCCCCCCC11CCC1CCCCCCCCC1
1C00C111CC1CCC11111CCC1CCC1CCCCCCCC11
1C001111CC1CCC1CCC1CCC1CCC1CCCC1CCC11
11001111CC1CCC1CCC1CCC1CCCCCC111CCC11
1100C111CC1CCC11CCCCC11CCCCCC111CCC11
11001111CC1CCC111111111CCCCCC111CCC11
1100C111CC11CCCCCCCCCCCCCCCCCC11CCCC1
111C1111CC1111111111111111CCCCCCCCCC1
1PC11CCCCCCCCCCC111111111111111CCCC11
1111111111111111111111111111111111111
