1111111
100E001
1000001
1C000P1
1111111