1111111
100E0P1
1000001
1C00001
1111111