111111111111111111111111
1EC0000000011C0000000001
101100010001101100010001
1CCC000001111000000C0001
10110001001111100110C001
1110000100010001000C0001
10110001011111111001P001
100011110000110000000001
101100C010110000110CC001
111111111111111111111111