11111111111111111111111111111111111111111111111111111
1000000000000000100101000000000000000000000000000ECP1
10000CCCCCCCCCCCCCC0000000000000000000000000000000001
10000CCCCCCCCCCCCCC0000000000000000000000000000000001
10000CCCCCCCCCCCCCC0000000000000000000000000000000001
10000000000000000000000000000000000000000000000000001
10000000000000000000000000000000000000000000000000001
10000CCCCCCCCCCCCCC0000000000000000000000000000000001
10000CCCCCCCCCCCCCC0000000000000000000000000000000001
10000CCCCCCCCCCCCCC0000000000000000000000000000000001
10000000000000000000000000000000000000000000000000001
10000000000000000000000000000000000000000000000000001
10000CCCCCCCCCCCCCC0000000000000000000000000000000001
10000CCCCCCCCCCCCCC0000000000000000000000000000000001
10000CCCCCCCCCCCCCC0000000000000000000000000000000001
10000000000000000000000000000000000000000000000000001
10000000000000000000000000000000000000000000000000001
10000CCCCCCCCCCCCCC0000000000000000000000000000000001
10000CCCCCCCCCCCCCC0000000000000000000000000000000001
10000CCCCCCCCCCCCCC000000000C000000000000000000000001
10000000000000000000000000000000000000000000000000001
10000000000000000000000000000000000000000000000000001
10000CCCCCCCCCCCCCC0000000000000000000000000000000001
10000CCCCCCCCCCCCCC0000000000000000000000000000000001
10000CCCCCCCCCCCCCC0000000000000000000000000000000001
10000000000000000000000000000000000000000000000000001
10000000000000000000000000000000000000000000000000001
11111111111111111111111111111111111111111111111111111
